#################################
#################################
####################### #########
#####$      ########### #########
########### ########### #########
########### #### ###### #########
###### #### ####             ####
###### #### #### ########### ####
###### #### #### ########### ####
###### ####      ########### ####
###### ######### ###         ####
#       ######## ######## ## ####
#######   ###### ######## ## ####
####### ######## ######## #######
####### ######## ######## #######
##               ######## %######
################     #### #######
#################### #### #######
#################################